malloc|void *|size_t,size|NULL|ENOMEM
calloc|void *|size_t,nmemb,size_t,size|NULL|ENOMEM
realloc|void *|void *,ptr,size_t,size|NULL|ENOMEM
mmap|void *|void *,addr,size_t,length,int,prot,int,flags,int,fd,off_t,offset|MAP_FAILED|EACCES,EAGAIN,EBADF,EINVAL,ENFILE,ENODEV,ENOMEM,EPERM,ETXTBSY,EOVERFLOW

fstat|int|int,fd,struct stat *,buf|-1|EACCES,EBADF,EFAULT,ELOOP,ENAMETOOLONG,ENOENT,ENOMEM,ENOTDIR,EOVERFLOW
lstat|int|const char *,pathname,struct stat *,buf|-1|EACCES,EBADF,EFAULT,ELOOP,ENAMETOOLONG,ENOENT,ENOMEM,ENOTDIR,EOVERFLOW
fstatat|int|int,dirfd,const char *,pathname,struct stat *,buf,int,flags|-1|EACCES,EBADF,EFAULT,ELOOP,ENAMETOOLONG,ENOENT,ENOMEM,ENOTDIR,EOVERFLOW,EBADF,EINVAL,ENOTDIR

# open and openat is specialized.
creat|int|const char *,pathname,mode_t,mode|-1|EACCES,EEXIST,EFAULT,EINTR,EINVAL,EISDIR,ELOOP,ENAMETOOLONG,ENFILE,ENOENT,ENOSPC,ENOTDIR,EOVERFLOW,EPERM
lseek|off_t|int,fd,off_t,offset,int,whence|-1|EBADF,EINVAL,EOVERFLOW,ESPIPE,ENXIO
read|ssize_t|int,fd,void *,buf,size_t,count|-1|EAGAIN,EBADF,EFAULT,EINTR,EINVAL,EIO,EISDIR
write|ssize_t|int,fd,const void *,buf,size_t,count|-1|EAGAIN,EBADF,EDESTADDRREQ,EDQUOT,EFAULT,EFBIG,EINTR,EINVAL,EIO,ENOSPC,EPERM,EPIPE
close|int|int,fd|-1|EBADF,EINTR,EIO

# fcntl
# ioctl

fopen|FILE *|const char *,path,const char *,mode|NULL|ENOMEM,EACCES,EEXIST,EFAULT,EINTR,EINVAL,EISDIR,ELOOP,ENAMETOOLONG,ENFILE,ENOENT,ENOSPC,ENOTDIR,EOVERFLOW,EPERM
fdopen|FILE *|int,fd,const char *,mode|NULL|EINVAL,ENOMEM
freopen|FILE *|const char *,path,const char *,mode, FILE *,stream|NULL|ENOMEM,EACCES,EEXIST,EFAULT,EINTR,EINVAL,EISDIR,ELOOP,ENAMETOOLONG,ENFILE,ENOENT,ENOSPC,ENOTDIR,EOVERFLOW,EPERM
# fread
# fwrite
# fseek

rename|int|const char *,oldpath,const char *,newpath|-1|EACCES,EBUSY,EDQUOT,EFAULT,EINVAL,EISDIR,ELOOP,EMLINK,ENAMETOOLONG,ENOENT,ENOMEM,ENOSPC,ENOTDIR,ENOTEMPTY,EEXIST,EPERM,EROFS,EXDEV
renameat|int|int,olddirfd,const char *,oldpath,int,newdirfd,const char *,newpath|-1|EACCES,EBUSY,EDQUOT,EFAULT,EINVAL,EISDIR,ELOOP,EMLINK,ENAMETOOLONG,ENOENT,ENOMEM,ENOSPC,ENOTDIR,ENOTEMPTY,EEXIST,EPERM,EROFS,EXDEV
# renameat2|int|int,olddirfd,const char *,oldpath,int,newdirfd,const char *,newpath,unsigned int,flags|-1|EACCES,EBUSY,EDQUOT,EFAULT,EINVAL,EISDIR,ELOOP,EMLINK,ENAMETOOLONG,ENOENT,ENOMEM,ENOSPC,ENOTDIR,ENOTEMPTY,EEXIST,EPERM,EROFS,EXDEV
link|int|const char *,oldpath,const char *,newpath|-1|EACCES,EDQUOT,EEXIST,EFAULT,EIO,ELOOP,EMLINK,ENAMETOOLONG,ENOENT,ENOMEM,ENOSPC,ENOTDIR,EPERM,EROFS,EXDEV
linkat|int|int,olddirfd,const char *,oldpath,int,newdirfd,const char *,newpath,int,flags|-1|EACCES,EBUSY,EDQUOT,EFAULT,EINVAL,EISDIR,ELOOP,EMLINK,ENAMETOOLONG,ENOENT,ENOMEM,ENOSPC,ENOTDIR,ENOTEMPTY,EEXIST,EPERM,EROFS,EXDEV
unlink|int|const char *,pathname|-1|EACCES,EBUSY,EFAULT,EIO,EISDIR,ELOOP,ENAMETOOLONG,ENOENT,ENOMEM,ENOTDIR,EPERM,EROFS
unlinkat|int|int,dirfd,const char *,pathname,int,flags|-1|EACCES,EBUSY,EFAULT,EIO,EISDIR,ELOOP,ENAMETOOLONG,ENOENT,ENOMEM,ENOTDIR,EPERM,EROFS,EBADF,EINVAL
truncate|int|const char *,path,off_t,length|-1|EACCES,EFAULT,EFBIG,EINTR,EINVAL,EIO,EISDIR,ELOOP,ENAMETOOLONG,ENOENT,ENOTDIR,EPERM,EROFS,ETXTBSY
ftruncate|int|int,fd,off_t,length|-1|EACCES,EFAULT,EFBIG,EINTR,EINVAL,EIO,EISDIR,ELOOP,ENAMETOOLONG,ENOENT,ENOTDIR,EPERM,EROFS,ETXTBSY
remove|int|const char *,pathname|-1|EACCES,EBUSY,EFAULT,EIO,EISDIR,ELOOP,ENAMETOOLONG,ENOENT,ENOMEM,ENOTDIR,EPERM,EROFS
symlink|int|const char *,target,const char *,linkpath|-1|EACCES,EDQUOT,EEXIST,EFAULT,EIO,ELOOP,ENAMETOOLONG,ENOENT,ENOMEM,ENOSPC,ENOTDIR,EPERM,EROFS
symlinkat|int|const char *,target,int,newdirfd,const char *,linkpath|-1|EACCES,EDQUOT,EEXIST,EFAULT,EIO,ELOOP,ENAMETOOLONG,ENOENT,ENOMEM,ENOSPC,ENOTDIR,EPERM,EROFS

opendir|DIR *|const char *,name|NULL|EACCES,EBADF,EMFILE,ENFILE,ENOENT,ENOMEM,ENOTDIR
fdopendir|DIR *|int,fd|NULL|EACCES,EBADF,EMFILE,ENFILE,ENOENT,ENOMEM,ENOTDIR

mkdir|int|const char *,pathname,mode_t,mode|-1|EACCES,EDQUOT,EEXIST,EFAULT,ELOOP,EMLINK,ENAMETOOLONG,ENOENT,ENOMEM,ENOSPC,ENOTDIR,EPERM,EROFS
mkdirat|int|int,dirfd,const char *,pathname,mode_t,mode|-1|EACCES,EDQUOT,EEXIST,EFAULT,ELOOP,EMLINK,ENAMETOOLONG,ENOENT,ENOMEM,ENOSPC,ENOTDIR,EPERM,EROFS,EBADF
rmdir|int|const char *,pathname|-1|EACCES,EBUSY,EFAULT,EINVAL,ELOOP,ENAMETOOLONG,ENOENT,ENOMEM,ENOTDIR,ENOTEMPTY,EPERM,EROFS
mkdtemp|char *|char *,template|NULL|EINVAL,EACCES,EDQUOT,EEXIST,EFAULT,ELOOP,EMLINK,ENAMETOOLONG,ENOENT,ENOMEM,ENOSPC,ENOTDIR,EPERM,EROFS
mkstemp|int|char *,template|-1|EACCES,EEXIST,EFAULT,EINTR,EINVAL,EISDIR,ELOOP,ENAMETOOLONG,ENFILE,ENOENT,ENOSPC,ENOTDIR,EOVERFLOW,EPERM
# mkostemp|int|char *,template,int,flags|-1|EACCES,EEXIST,EFAULT,EINTR,EINVAL,EISDIR,ELOOP,ENAMETOOLONG,ENFILE,ENOENT,ENOSPC,ENOTDIR,EOVERFLOW,EPERM

mkfifo|int|const char *,pathname,mode_t,mode|-1|EACCES,EDQUOT,EEXIST,ENAMETOOLONG,ENOENT,ENOSPC,ENOTDIR,EROFS
mkfifoat|int|int,dirfd,const char *,pathname,mode_t,mode|-1|EACCES,EDQUOT,EEXIST,ENAMETOOLONG,ENOENT,ENOSPC,ENOTDIR,EROFS

dup|int|int,oldfd|-1|EBADF,EBUSY,EINTR,EINVAL,EMFILE
dup2|int|int,oldfd,int,newfd|-1|EBADF,EBUSY,EINTR,EINVAL,EMFILE

pread|ssize_t|int,fd,void *,buf,size_t,count,off_t,offset|-1|EAGAIN,EBADF,EFAULT,EINTR,EINVAL,EIO,EISDIR
pwrite|ssize_t|int,fd,const void *,buf,size_t,count,off_t,offset|-1|EAGAIN,EBADF,EDESTADDRREQ,EDQUOT,EFAULT,EFBIG,EINTR,EINVAL,EIO,ENOSPC,EPERM,EPIPE

chdir|int|const char *,path|-1|EACCES,EFAULT,EIO,ELOOP,ENAMETOOLONG,ENOENT,ENOMEM,ENOTDIR
fchdir|int|int,fd|-1|EACCES,EBADF

chown|int|const char *,pathname,uid_t,owner,gid_t,group|-1|EACCES,EFAULT,ELOOP,ENAMETOOLONG,ENOENT,ENOMEM,ENOTDIR,EPERM,EROFS
fchown|int|int,fd,uid_t,owner,gid_t,group|-1|EBADF,EIO,ENOENT,EPERM,EROFS
lchown|int|const char *,pathname,uid_t,owner,gid_t,group|-1|EACCES,EFAULT,ELOOP,ENAMETOOLONG,ENOENT,ENOMEM,ENOTDIR,EPERM,EROFS
fchownat|int|int,dirfd,const char *,pathname,uid_t,owner,gid_t,group,int,flags|-1|EACCES,EFAULT,ELOOP,ENAMETOOLONG,ENOENT,ENOMEM,ENOTDIR,EPERM,EROFS,EBADF,EINVAL,ENOTDIR

chmod|int|const char *,pathname,mode_t,mode|-1|EACCES,EFAULT,EIO,ELOOP,ENAMETOOLONG,ENOENT,ENOMEM,ENOTDIR,EPERM,EROFS
fchmod|int|int,fd,mode_t,mode|-1|EBADF,EIO,EPERM,EROFS
fchmodat|int|int,dirfd,const char *,pathname,mode_t,mode,int,flags|-1|EACCES,EFAULT,EIO,ELOOP,ENAMETOOLONG,ENOENT,ENOMEM,ENOTDIR,EPERM,EROFS,EINVAL,EBADF

getgrnam|struct group *|const char *,name|NULL|ENOENT,ESRCH,EBADF,EPERM,EINTR,EIO,EMFILE,ENFILE,ENOMEM,ERANGE
getgrgid|struct group *|gid_t,gid|NULL|ENOENT,ESRCH,EBADF,EPERM,EINTR,EIO,EMFILE,ENFILE,ENOMEM,ERANGE
getpwnam|struct passwd *|const char *,name|NULL|ENOENT,ESRCH,EBADF,EPERM,EINTR,EIO,EMFILE,ENFILE,ENOMEM,ERANGE
getpwuid|struct passwd *|uid_t,uid|NULL|ENOENT,ESRCH,EBADF,EPERM,EINTR,EIO,EMFILE,ENFILE,ENOMEM,ERANGE

# getgrent
# setgrent
# endgrent

kill|int|pid_t,pid,int,sig|-1|EINVAL,EPERM,ESRCH
nice|int|int,inc|-1|EPERM

# renameatu|int|int,fd1,char const *,src,int,fd2,char const *,dst,unsigned int,flags|-1|EACCES,EBUSY,EDQUOT,EFAULT,EINVAL,EISDIR,ELOOP,EMLINK,ENAMETOOLONG,ENOENT,ENOMEM,ENOSPC,ENOTDIR,ENOTEMPTY,EEXIST,EPERM,EROFS,EXDEV
# full_write|size_t|int,fd,const void *,buf,size_t,count|-1|EAGAIN,EBADF,EDESTADDRREQ,EDQUOT,EFAULT,EFBIG,EINVAL,EIO,ENOSPC,EPERM,ESPIPE
# safe_read|size_t|int,fd,void *,buf,size_t,count|SAFE_READ_ERROR|EAGAIN,EBADF,EFAULT,EINVAL,EIO,EISDIR
# creat_safer|int|const char *,pathname,mode_t,mode|-1|EACCES,EEXIST,EFAULT,EINTR,EINVAL,EISDIR,ELOOP,ENAMETOOLONG,ENFILE,ENOENT,ENOSPC,ENOTDIR,EOVERFLOW,EPERM
# fopen_safer|FILE *|const char *,path,const char *,mode|NULL|ENOMEM,EACCES,EEXIST,EFAULT,EINTR,EINVAL,EISDIR,ELOOP,ENAMETOOLONG,ENFILE,ENOENT,ENOSPC,ENOTDIR,EOVERFLOW,EPERM
# freopen_safer|FILE *|const char *,path,const char *,mode, FILE *,stream|NULL|ENOMEM,EACCES,EEXIST,EFAULT,EINTR,EINVAL,EISDIR,ELOOP,ENAMETOOLONG,ENFILE,ENOENT,ENOSPC,ENOTDIR,EOVERFLOW,EPERM
